NO ./images/North.xpm
SO ./images/South.xpm
WE ./images/West.xpm
EA ./images/East.xpm

F 129,158,150
C 100,30,0


111111111111111111111111111
100000000000000000000001001
11N000000000000000000001001
100000011111110000000000001
100000011011110000000000001
100000011011110000000000001
100000011011110000000000001
100000011011110000000000001
100000011000000000000000001
101111111111111100000000001
101111111111111100000000001
100000011000000000000000001
100000011000000000000000001
101000011000000000000000001
101000011000000000000000001
111111111111111111111111111