NO ./images/North.xpm
SO ./images/South.xpm
WE ./images/West.xpm
EA ./images/East.xpm

F 0,50,50
C 0,30,0

        1
        1
1111111111111111
1000100000000101
10001001000010011111111111
100E000100000001
1010000100000001
1010000000111001
111111111111111111111
1
1